#^.^~****^*~~.~^~..~~~^~.^~.*~**.^^*^*^~..*^^..~^.
*#*~*.~^^^~~.*~*.**.~~^*^**.^~*^^.*^...^..^.**.~^*
^^#**~.*^*^..^**.~~~.~*.~^^~^~^.^~^*~**.~*^.^**.*.
*~~#~^.~*~^~^^*^**.~.*^^*~~^^*~.^.*^^*^.^.~~^^^*~.
*.^~#^.~^.^.^^*~^~~*^..^~^~~^.*^^..**.**~.~~^~*~**
^.^^~#.*~**.*~*^*~^*~~^.^.~.~^**~.^^^^*.~.~~~^^.^.
*~~.*#^~~~^*.^*~~~*^.^**^*^.^.^~~***^^*^.~^^.^^.~.
.~.*~~#*.**.~^^~**^.^.^~~~^.~.^~~^^.~^^.^^~.~.~.*^
.^^^~~#~.^.~.*~.~~..~*~^.~**~..^****~.*~^~~*~**^~^
^^^*^^*#...*.^^*^^^.*~*~^^~*~~.~****~~~~***.^^~~^~
..*^^^^^#^~.^~.^.^^~*~^*~**^*^.~~~*^.^^~**~*~.....
**.^~~~^~#~****.**^~.^.*^^^~.^...~.**^^^^~^.~^~.~*
^*~.*.~*^#~.^^^^^*~.**~^.*^*.~~..^~~~*~*^.~~^*^*^^
~*^.^..**~###*^~***^~~*^*.*~..~^^***^.*~.^*^^^^.~.
*~^~^**^^*^#~#*~^^*~~~*^*~~~~*~^^^*~..~~~~~.*~^~*.
^.*.^*^**^##~*#.*.~^~~~^..~~~*~~^*~..^^.^~*.^~^~**
.***^..*^~~~~^~#*^~~.*.~^.^^*.***^~^.*....~.^.*~^^
^^~~~~.**.*.^^*#^~~^....*~*^~*^^.^~~~^*.~^^^~**^~~
^~~*^*.~.*^^^*^.##.~*...~**^.^^~.^^.^..^.^**.^^..*
~^***~^.~.~^^^*~~~#*..^~^^.~^.~.**...~^~**~^~~**^~
~~~^~.^*.^*.~*.*~~^#.~*^^~~**.*.*.~^^^..^.~^.*.^~~
^^~...^.*~.^^**~^~*.#^~^~*....^.^^**~.*.^^*..~*~.*
^..^...~.~.*.~***~*~~#..~*~^^~~^~**^~~^*^^~*.~*^*^
*^.**^~*****.~~~..~^~.#.^*~^.^^*^..*~^.^.^*.^.~^^*
~...~*^....*^.*^^*...^#~~..^.*~.*~.*^.^*^*^.****^~
^..~***^.*^~~.****.~*^#~.^~*.~^*^~^.****~..~*..*^~
.~^~**~^^..~~~^..*~*.^*#~..^^*.~.*..*~~*~.^~.~*~~.
.***~..~**^.~.~.~*.~~**.#^.^~..~*~~~~*.**~~^..^.^^
~.*.~^*^*~^.~*..*~^~~.*.*#.*.*..^~.*~^^*.~^.^~^**^
.*^~^^*.^*.~*...*~~~*.**.~#..*.*^.^*.^*~*.^~^**^*.
.~..*....~..~.***~..~^..~~^#^*^~^^~~**^.*~**^**^^*
^.*.~.^.**^*^.~^^*.~..*^~*^*##.~**..^.~~*..^*^~*.~
^~~^~~*.~^^~~^**.^.^^^*^.*^^~~#^.*~^*^^..**..**..^
^.^*.*^..*.~~.^^***^.*~..~.**^*.~^...^^~*.~^~^..~~
~^^.^..*^^.**.~~^*~*^~*~^~~.~*#^~.~*^~*.*..^.^^*^*
^^.~*^~~*.~~*~.^..~*.^.~**.^*^#^~.**.~*.~...~~..*.
.~..^.~.~.^*.~^*~.~.*^*~~*.^.**#***~*~~*^~~~^.~~*~
~.*..^^*^~*.~~.~.^~..~.~^^^.*~*.#*~^*~*^*^^~..^~^^
*.^*^**^*.^^*....**..~^^~.^*^.*~*#**^^.#*.^^*^^^.~
^*^~^^*.~*~^*~^~~.*.^*^~*^^~.*~.*~#**.*~#~~.~*^~~*
~~**~*.^.*~..~~^^^~^^^.~***^*.^*~^#~^~#~*##..~..~.
*~**^~~.^.*.~^**~*^^.*^*.^~~*~~~*^.##.~~^*^#*^.^.*
.*^~..*~.*^^^^^~~^^*.~*.~~~.***~^.*.#~~*****#~~^*.
.^^..^.^*^~^.~*...**~~~.**^*~~~*^**#~#*^~^~~^#^*.*
**.**~.**~.*.*^~~.~^.*^.~~*.^*.~.###~*#^..~*.~#^*^
~..^.****^.****~^~***..^^^^*^.~*^^*#~~#^**^*~^*#~~
^*~^.~*...^^.^~.^^..~^...**...^###*##~#~*^..~^*~#~
...^~^.~^^~~~~.*^~.^~***~~^^^.#^^#~###~#~**^***^~#
.~~~~~^^.~~*^.~^^^**~^~.^~^~*..#*~^^*.##~^~**.*.^#
~^**.~**..*^~^^^.^*^~^~*^.~*~###########~**^~~^~^#
