#^.^~****^*~~.~^~..~~~^~.^~.*~**.^^*^*^~..*^^..~^.
*#*~*.~^^^~~.*~*.**.~~^*^**.^~*^^.*^...^..^.**.~^*
^^#**~.*^*^..^**.~~~.~*.~^^~^~^.^~^*~**.~*^.^**.*.
*~~#~^.~*~^~^^*^**.~.*^^*~~^^*~.^.*^^*^.^.~~^^^*~.
*.^~#^.~^.^.^^*~^~~*^..^~^~~^.*^^..**.**~.~~^~*~**
^.^^~#.*~**.*~*^*~^*~~^.^.~.~^**~.^^^^*.~.~~~^^.^.
*~~.*#^~~~^*.^*~~~*^.^**^*^.^.^~~***^^*^.~^^.^^.~.
.~.*~~#*.**.~^^~**^.^.^~~~^.~.^~~^^.~^^.^^~.~.~.*^
.^^^~~#~.^.~.*~.~~..~*~^.~**~..^****~.*~^~~*~**^~^
^^^*^^*#...*.^^*^^^.*~*~^^~*~~.~****~~~~***.^^~~^~
..*^^^^^#^~.^~.^.^^~*~^*~**^*^.~~~*^.^^~**~*~.....
**.^~~~^~#~****.**^~.^.*^^^~.^...~.**^^^^~^.~^~.~*
^*~.*.~*^#~.^^^^^*~.**~^.*^*.~~..^~~~*~*^.~~^*^*^^
~*^.^..**~###*^~***^~~*^*.*~..~^^***^.*~.^*^^^^.~.
*~^~^**^^*##~#*~^^*~~~*^*~~~~*~^^^*~..~~~~~.*~^~*.
^.*.^*^**^##~*#.*.~^~~~^..~~~*~~^*~..^^.^~*.^~^~**
.***^..*^~~~~^~#*^~~.*.~^.^^*.***^~^.*....~.^.*~^^
^^~~~~.**.*.^^*#^~~^....*~*^~*^^.^~~~^*.~^^^~**^~~
^~~*^*.~.*^^^*^.##.~*...~**^.^^~.^^.^..^.^**.^^..*
~^***~^.~.~^^^*~~~#*..^~^^.~^.~.**...~^~**~^~~**^~
~~~^~.^*.^*.~*.*~~^#.~*^^~~**.*.*.~^^^..^.~^.*.^~~
^^~...^.*~.^^**~^~*.#^~^~*....^.^^**~.*.^^*..~*~.*
^..^...~.~.*.~***~*~~#..~*~^^~~^~**^~~^*^^~*.~*^*^
*^.**^~*****.~~~..~^~.#.^*~^.^^*^..*~^.^.^*.^.~^^*
~...~*^....*^.*^^*...^#~~..^.*~.*~.*^.^*^*^.****^~
^..~***^.*^~~.****.~*^#~.^~*.~^*^~^.****~..~*..*^~
.~^~**~^^..~~~^..*~*.^*#~..^^*.~.*..*~~*~.^~.~*~~.
.***~..~**^.~.~.~*.~~**.#^.^~..~*~~~~*.**~~^..^.^^
~.*.~^*^*~^.~*..*~^~~.*.*#.*.*..^~.*~^^*.~^.^~^**^
.*^~^^*.^*.~*...*~~~*.**.~#..*.*^.^*.^*~*.^~^**^*.
.~..*....~..~.***~..~^..~~^#^*^~^^~~**^.*~**^**^^*
^.*.~.^.**^*^.~^^*.~..*^~*^*##.~**..^.~~*..^*^~*.~
^~~^~~*.~^^~~^**.^.^^^*^.*^^~~#^.*~^*^^..**..**..^
^.^*.*^..*.~~.^^***^.*~..~.**^*#~^...^^~*.~^~^..~~
~^^.^..*^^.**.~~^*~*^~*~^~~.~*#^~.~*^~*.*..^.^^*^*
^^.~*^~~*.~~*~.^..~*.^.~**.^*^#^~.**.~*.~...~~..*.
.~..^.~.~.^*.~^*~.~.*^*~~*.^.**#***~*~~*^~~~^.~~*~
~.*..^^*^~*.~~.~.^~..~.~^^^.*~*.#*~^*~*^*^^~..^~^^
*.^*^**^*.^^*....**..~^^~.^*^.*~*#**^^.#*.^^*^^^.~
^*^~^^*.~*~^*~^~~.*.^*^~*^^~.*~.*~#**.#~#~~.~*^~~*
~~**~*.^.*~..~~^^^~^^^.~***^*.^*~^#~^~#~*##..~..~.
*~**^~~.^.*.~^**~*^^.*^*.^~~*~~~*^.###~~^*^#*^.^.*
.*^~..*~.*^^^^^~~^^*.~*.~~~.***~^.*##~~*****#~~^*.
.^^..^.^*^~^.~*...**~~~.**^*~~~*^**#~#*^~^~~^#^*.*
**.**~.**~.*.*^~~.~^.*^.~~*.^*.~.*##~*#^..~*.~#^*^
~..^.****^.****~^~***..^^^^*^.~*####~~#^**^*~^*#~~
^*~^.~*...^^.^~.^^..~^...**...^######~#~*^..~^*~#~
...^~^.~^^~~~~.*^~.^~***~~^^^.####~###~#~**^***^~#
.~~~~~^^.~~*^.~^^^**~^~.^~^~*####~######~^~**.*.^#
~^**.~**..*^~^^^.^*^~^~*^.~*~###########~**^~~^~^#
